{
  "maze": [
    [1,1,1,1,1,1,1,1,1,1,1,1,1,1,1],
    [1,0,0,0,1,0,0,0,0,0,1,0,0,0,1],
    [1,0,1,0,1,0,1,1,0,1,1,0,1,0,1],
    [1,0,1,0,0,0,0,1,0,0,0,0,1,0,1],
    [1,0,1,1,0,1,0,1,1,0,1,0,1,0,1],
    [1,0,0,0,0,1,0,0,0,0,1,0,0,0,1],
    [1,1,1,0,1,1,0,1,0,1,1,1,0,1,1],
    [1,0,0,0,0,0,0,0,0,0,0,0,0,0,1],
    [1,0,1,1,0,1,1,0,1,0,1,1,0,1,1],
    [1,0,1,0,0,0,0,0,0,0,0,1,0,0,1],
    [1,0,1,0,1,0,1,1,0,1,0,1,0,1,1],
    [1,0,0,0,0,0,0,1,0,0,0,0,0,0,1],
    [1,1,1,0,1,0,1,0,1,0,1,0,1,1,1],
    [1,0,0,0,0,0,0,0,0,0,0,0,0,2,1],
    [1,1,1,1,1,1,1,1,1,1,1,1,1,1,1]
  ],
  "start": [1, 1],
  "description": "Laberinto temático dragones y mazmorras. 0=pasillo, 1=pared, 2=salida"
}